┌─────────────────────────────────┐
│     Depth-First Search Maze     │
├─────────────────────────────────┤
│ ███████████████████████████████ │
│ █   █       █     █   █     █ █ │
│ █ ███ █ ███ █ █ ███ █ █ ███ █ █ │
│ █     █   █ █ █   █ █ █   █ █ █ │
│ █ ███████ ███ ███ █ █████ █ █ █ │
│ █ █     █     █ █ █ █     █   █ │
│ █ █ ███ ███████ █ █ █ █ █████ █ │
│ █ █ █         █ █   █ █ █   █ █ │
│ █ ███ ███████ █ ███████ ███ █ █ │
│ █   █ █ █     █       █   █   █ │
│ ███ █ █ █ █████ █████ █ █ ███ █ │
│ █ █   █ █   █   █   █ █ █   █ █ │
│ █ █████ ███ ███ ███ █ █████ █ █ │
│ █ █         █   █   █ █     █ █ │
│ █ █ █████████ ███ ███ █ █████ █ │
│ █   █       █ █   █   █ █     █ │
│ █ ███ █ ███ █ ███ █ ███ ███████ │
│ █   █ █ █   █   █     █ █     █ │
│ ███ █ █ ███ ███ █████ █ █ ███ █ │
│ █ █ █ █   █   █     █ █     █ █ │
│ █ █ █████ ███ █████ █ █ █████ █ │
│ █ █ █   █   █   █   █ █ █   █ █ │
│ █ █ █ █ ███ ███ █ ███ ███ █ █ █ │
│ █     █     █     █       █   █ │
│ ███████████████████████████████ │
└─────────────────────────────────┘