┌─────────────────────────────────┐
│     Kruskal's Algorithm Maze    │
├─────────────────────────────────┤
│ ███████████████████████████████ │
│ █   █ █   █   █   █     █     █ │
│ █ ███ █ █ █ █████ █ █ ███ █████ │
│ █       █   █ █   █ █ █       █ │
│ █ ███ ███ ███ ███ █ █ █████ ███ │
│ █ █     █   █       █   █     █ │
│ █ █████ ███ ███ ███ █████████ █ │
│ █ █       █ █   █         █   █ │
│ █ █████ █████ ███ █ █████████ █ │
│ █ █         █ █ █ █   █ █ █ █ █ │
│ █████ █ ███████ █ █████ █ █ █ █ │
│ █ █   █   █ █           █     █ │
│ █ ███████ █ █ ███ █████ █ ███ █ │
│ █ █ █       █ █   █   █ █ █   █ │
│ █ █ █ ███████ ███████ █ █ ███ █ │
│ █             █     █     █ █ █ │
│ █ ███████ █████ ███ ███████ █ █ │
│ █ █   █ █   █   █           █ █ │
│ █████ █ █ █████ █ █ █ █ ███ █ █ │
│ █               █ █ █ █   █ █ █ │
│ ███ █ ███ █████ ███ ███████ █ █ │
│ █ █ █ █       █   █ █     █ █ █ │
│ █ █ █ █ █ ███ ███ █ ███ █ █ ███ │
│ █   █ █ █   █ █   █ █   █     █ │
│ ███████████████████████████████ │
└─────────────────────────────────┘