┌─────────────────────────────────┐
│      Prim's Algorithm Maze      │
├─────────────────────────────────┤
│ ███████████████████████████████ │
│ █ █     █     █   █ █         █ │
│ █ ███ █ █████ ███ █ █ ███ █ ███ │
│ █     █     █   █       █ █   █ │
│ ███████████ ███ ███ █ █ ███ █ █ │
│ █ █ █ █   █ █   █   █ █   █ █ █ │
│ █ █ █ ███ █ ███ █ ███ █ █ █████ │
│ █ █   █             █ █ █     █ │
│ █ ███ █████ ███ █ █████ ███ ███ │
│ █       █ █ █   █   █     █   █ │
│ █ ███ █ █ █████ █ ███ █ █ █ ███ │
│ █   █ █         █   █ █ █ █   █ │
│ █ █████ █ █████ ███ ███ █ █ █ █ │
│ █ █ █ █ █ █       █ █   █ █ █ █ │
│ ███ █ ███ █ ███ █ ███ ███ █████ │
│ █         █   █ █ █     █   █ █ │
│ █████ █ █ ███ █ ███████ █ ███ █ │
│ █     █ █ █   █     █   █     █ │
│ ███ █ ███ █ ███ █ █ █ █ █ █ ███ │
│ █   █ █   █   █ █ █ █ █ █ █   █ │
│ ███████ ███ █ █ █ ███ █ █ █ █ █ │
│ █         █ █ █ █   █ █ █ █ █ █ │
│ ███████ █ ███ █ █████ ███ █ █ █ │
│ █       █   █ █   █   █   █ █ █ │
│ ███████████████████████████████ │
└─────────────────────────────────┘