┌─────────────────────────────────┐
│     Wilson's Algorithm Maze     │
├─────────────────────────────────┤
│ ███████████████████████████████ │
│ █       █ █   █ █   █     █   █ │
│ █ █████ █ ███ █ █ ███ █ ███ ███ │
│ █ █ █         █ █     █       █ │
│ █ █ ███████ ███ █ █████████ ███ │
│ █   █ █ █           █ █   █ █ █ │
│ █████ █ ███████ █████ █ ███ █ █ │
│ █       █   █   █ █           █ │
│ █ █ █ █ █ █ █████ ███ █████ ███ │
│ █ █ █ █   █             █   █ █ │
│ ███ █████ █ █████ ███ ███ ███ █ │
│ █     █ █ █ █ █ █   █ █   █   █ │
│ ███ █ █ █ ███ █ ███ █████████ █ │
│ █ █ █   █ █ █       █ █     █ █ │
│ █ ███ █ ███ ███ █████ █ ███ █ █ │
│ █   █ █ █     █   █       █   █ │
│ █ █ ███ █ █ █████████ █████ ███ │
│ █ █ █     █ █ █   █     █   █ █ │
│ ███ █ ███ ███ ███ █████████ █ █ │
│ █   █   █       █     █       █ │
│ █ ███ ███ █ █ ███ ███ █ █ █ ███ │
│ █       █ █ █     █     █ █ █ █ │
│ █ ███████ ███ █████ █ ███ █ █ █ │
│ █ █         █ █     █   █ █   █ │
│ ███████████████████████████████ │
└─────────────────────────────────┘